##################################################
#.O.O.#..O...OO.O..#.......O#..O.OO..O..#.OOOOO.O#
#.#OO.....O...OO....OOO.OOO...#OO..O.#..O.OOO..O.#
#..O.O.#..OOO.....#OO.O####.OO..OO#O...O#.....O..#
#........#...O..O.OOO.........O....#O..#O.....#..#
#OO.O#.O..O...O..O.........#..O....O.O.O..OOO...##
#........O..OO...O.#O...O....#.O...O..O.#..OO..O.#
#.O.......#O.#O.OO...O...#OO....O.O...OO...O.OO.##
#.#..O.OO....OO.O#..OO..OO...O..#.....O.O.......##
#........O.....OO.O.OO....OOOO..OOO#.#O....O.OO.O#
#..O.O.##OOO#..#..#O#.O#O.#..OO.OOO...OO.O.......#
#OO.O#.O.....#...OO..O..#.....O.OO..O...OO...O.O.#
#.OO.OO...OO....O.#.O.....O....#O....#O....O.O..O#
#.......#.O....O...#....O.O..O......#....O..OOO..#
#.........O...OO....OO.#O...O.O..O...O.O#...#O...#
#O......O.....#....OO#OO...OO..O.....O.#...O..O..#
#OO..O......O#OOO...O...O#.O.OO....OOO.#.....O.O.#
#.O...OO..#O.#.#..OOOO##.O#.....O....OO......O#OO#
#O......#..O.O..#...OOO.O.....#....O.O.O..O......#
#.##.#O.O...O...O.#..O...OO.OO...OO.....O.....OO.#
#..#.....O......O#...#OO..O........O..O...#..#.#.#
#..O..O#O#OO....#...O.OO..#..........O.OO.#O.O...#
#..O#.O.O.O...O.OO..O.O.O.O.O.O...OOO#.#.O##.O...#
#O....O..O.OO.OOO..OOOOOO.O.OO..O...O..O....O..###
#...OO.O..OO..O...#....#@...O.O...OO.O#.....O...O#
#.....#...OO..O...O.......#.OO..#.O....O..#..O..##
#....OOOO...#..#O........O.OOOO..O........#O..O..#
#....O....##.....O..O....O#....O...O.OO.....OO...#
#O..#....O...O.OOO.O..O......O..#O.#.O.O.O...OO..#
#..O##O.#.......O.......O..O......#.OO..O...OOO#O#
#....O#O..#..O.#O......O..#OO...OO....##O.......O#
#....O...O......O.....O.O.O..OO...#......O.#.#...#
#..O..O.......#O........O.#....O..O....#.O.O#O..O#
##..........#...O.......O.O....OO.#OO.O.#....O..O#
#.O........#.#OO.O.O..#O..OO..O#O...O.O.O.OO.#O.O#
#.#OO..OO.....O...O.O...O...O.OO........O#O...O.O#
#..O.O#.O.......O....OO....#O.OOO...#...OOO...#..#
#...#OOO#.....#......#O....O..O.#......O........O#
#.....O...O#O..O..O...#.O.O..O#..#OO.....OOO...O.#
#O.O....OO.O...#O..O..O##....O..O.....#.O....OO.O#
#.....#OOO.O....OO.O.....OO......O.OOO....#....#O#
#....OO..O..O.O...O.OO.O..#..O.....O.#....OO.O...#
##.O...OO#O..#....O...O.O...#..O.......#....O#..##
#..O.O...O...O#.O.O...OOO...O.OOO.....O.OO....O..#
#O..O.OO#.O#OO....#O.O...O.......O...OO.....O..O.#
#........O......#O.......#O#........O.OO.O..O##..#
#.#..O.OO#..#...O..O#.O.....#O..#...#....O#O.....#
#.O.O...O....O.O..O................#..OO...O..O.O#
#O..OO..#.O.O#.O.#OO...OO..O..O...O.O..O#.OO.O.O.#
##################################################